composants qui arrive et comment les branch√©s: 




1Ô∏è‚É£ Architecture retenue (simple & robuste)

Fonction	Composant
Temp√©rature / Humidit√©	DHT22
Pression atmosph√©rique	BMP280 (I2C)
Luminosit√©	LDR (ADC)
Horodatage	Temps interne (RTC optionnel)
Stockage	Module carte SD (SPI)
MCU	Raspberry Pi Pico
Langage	MicroPython



2Ô∏è‚É£ Branchement conseill√© (Pico)
üîπ DHT22
DHT22	Pico
DATA	GP15
VCC	3.3V
GND	GND

üîπ BMP280 (I2C)
BMP280	Pico
SDA	GP0
SCL	GP1
VCC	3.3V
GND	GND

üîπ LDR (pont diviseur)
√âl√©ment	Pico
Signal	GP26 (ADC0)

üîπ Module SD (SPI)
SD	Pico
CS	GP5
MOSI	GP3
MISO	GP4
SCK	GP2